        111111111111111111111111
        1000000000110000000000001
        1011000001110000000000001
        1001000000000000000000001
111111111011000001110000000000001
100000000011000001110111100101111
1111011111111101110000001000011
11110111111111011101010010000111
110000001101010111000000100000011
1000000000000001100000010000101
1000000000000000110101001000N00011
11000001110101011111011110000111
11110101 1110101 101111010001
11111111 1111111 111111111111
